         OO
------- OYOO -------
OOOOOO OO COO OOOOOO
OOOOO OO WQ OO OOOOO
OOOO OO 4OO4 OO OOOO
OOOO I 4O44O4 I OOOO
OOOO I O----O I OOOO
OOOO I        I OOOO
OOOO I O----O I OOOO
OOOO I I    I I OOOO
---- I@I    I I ----
     O-O    O-O